#################################
# #     # #         #         # #
# # ### # # ### ##### # ##### # #
# # # # #     #       # #   #   #
# # # # ########### ### # # #####
#   # #     #     # # #   #     #
# ### ##### # ### # # ####### # #
# #     # # # # # #       # # # #
# # ### # # # # # ######### ### #
# #   #   # #   #   #       #   #
# ### ### # ### ### # ####### # #
# #   # # #     # #   #   #   # #
# # ### # ####### ##### # # ### #
# #   # #       #   #   # # # # #
# ### # ####### # # # ### # # # #
#     #           #   #     #   #
#################################