#####################################################################################################
#                   #     #         #   #         #     #         #     #       #       #       #   #
# ### ############# # # ### # ##### # # ### ##### # ### # # ####### ### # ### # ### ### ##### # # # #
#   # #         # #   # #   # #   #   #     # #   # #   # #   #     #   #   # # #   #   #     #   # #
### ### ####### # ##### # ### # # ########### # ### # ### ### # ##### ### ### # # ### ### ###########
#   #     #     #       # # # # #   #           #   #   #   #       #     #   # # #   #         #   #
# ### ##### ##### ####### # # # ### ### ######### ##### ### ######### ##### ### # # ######### # # # #
#     #   # #           #   # #   #   #     #     #   #   # #   #   #   #   # # # # #       # # # # #
# ##### # # ########### ### # # ##### ##### ### # # # ### # # # # # ##### ### # # # # ##### # # # # #
# #   # #   #         # #   #   #     #   #   # # # #   # # # #   #     # #   #   #   #   # # #   # #
# # # # ### # ####### ### ####### ##### # ### # # # ##### ### ######### # ### ######### # # ####### #
# # # #   # # #     #     #     #   # # #     # # #       #   #     #   #   #           # #   #     #
### # ### ### # # # ########### ### # # ######### # ####### ### ### # ### # ##### ##### ##### # ### #
#   # #   #   # # #   #           # #       #     #       #   # # # # #   #     #     #       # # # #
# ### # ### ### # ##### ### # ##### ####### ### ######### ### # # # # ######### ##### ######### # # #
# #   #   # #   #       #   # #   #       # #   # #     #   # # #   #         #     #     #     #   #
# # ##### # # ########### ##### # ####### # # ### # # ##### # # ############# # ### ##### # ##### ###
# #     # # #     #     #   #   #   #     #   #   # #     #   #       #       # # #   #     #   # # #
# ##### # # ##### ### # ### # ##### # ######### # # ### # ######### ### ####### # ### ####### ### # #
#   # #   #   #       #   # #     #   # #       # # # # # #         #   #     #     # #   #   #   # #
### # ### ### ############# ##### ##### # ####### # # # ### # ##### # ### # ##### ### # # ### # ### #
#   #       #         #     #   # #   # #   # #   #   #     # #     # #   #       #   # #   # #   # #
# ### ############### # ### # # # # # # ### # # # ### ####### ####### ######### ### ### ### # ### # #
# #   #           # #   #     # # # #     # # # # #   #     #                 # #   #     # # #   # #
# ### # ####### # # ##### ####### # ##### # # # ### ### ### ################# ### ### ##### # # ### #
#   # #       # #   #   # # #     # #   # # # #     # #   # #     #       #     #     #     #       #
# # ### ####### ### # # # # # ##### # # # # # ####### # # # # # ### ##### ##### ####### ########### #
# #     #     #   # # # # # # #     # #   # #         # # #   # #   #   #     #   #   # #     #   # #
# ####### ### ### ### # # # # # ### ####### ####### ### # ### ### ### # ##### ### # # # # ### # # # #
# #       # #     #   #   # # #   #               #     #   # #   #   # # #   # #   # # # # #   # # #
# # ####### ##### # ####### # ### ############### # ####### # # ### ### # # ### ##### # # # ##### # #
# #     # #     # # #       #   #     #     #   # #   #   # # # #     #   #   #   #   #     #     # #
####### # # ### # # # ##### ### ### ### ### # # # # ### # # # # ##### # ##### # ### ### ##### ##### #
#       # #   #   # #   #     #   # #     # # # # # #   #   # # #     # #     #     #     #   #   # #
# ####### ### ##### # ### ### ### ### ##### # ### ### # ####### # ### ### ##### ########### ##### # #
# #   #     # #     # #   # #   #     #   # #   #   # # #     # # #   #   #   #     #     #     #   #
# # # ### ### # ##### # ### ### ####### # # # # ### # # # ### # # # ### # # # ##### # ### ### # #####
#   #   # #   #     # #   #         #   #   # #       # # # # #   # #   # # #     #   # #   # #     #
####### # # ####### # ### ##### ##### # ##### ########### # # ##### # ### # ##### ##### ### # ##### #
#     # #   #     # #   # #   # #     # #   #     #   #     #   # # #   # #   #   #   #   # # #     #
# ### # # ### # ### ##### # # ### ####### # ####### # # ##### # # # ### ### ### ##### # # # # # ### #
# #     #   # # #   #     # #     #       #   #   # # # # #   #   #   #     #   #     # #   # #   # #
# ######### # # # ### ### # ####### ######### # # # # # # # ######### ####### ### ### # ##### ### ###
#   #         # # #   #   # #       #       #   #   #     # #       #     #   #   # # #     #   #   #
# # ############# # ####### # ############# ############### # ##### ##### # ### ### # ##### ### ### #
# #       #       # #     #   #               #   #         # #   #     # #   #   #       #   #   # #
# ####### # ####### # ### ##### ############# # # # ##### ### # # ##### # ### # # ####### ### ##### #
#   #     #       #     #   #   #     #     #   # # #     #   # #     #   # # # #   #     #   #     #
### # ########### # ##### ### # # ### # ##### ##### ####### ### ##### ##### # # ### ##### # ### ### #
#   # #     #   # # #   #     # #   #   #     #   #   #     #   #   # #     # #   #     # #     # # #
# ### # # ### # # ### # # ##### # # ### # ##### # ### # ##### ### # # # ### # ##### ### # ####### # #
# #   # #     # #     # # #     # # #   # #     #   # # #     # # #     # # # #   #   # #   #       #
# # ### ####### ####### ### ##### # ### # # ####### # # # ##### # ####### # # # # ### # ##### #######
# #   #       #       #     #   # #   # # #     # #   # #   #     #     #   #   # #   #       #     #
##### ####### ### ########### # # ### # # ##### # ### # ### # ##### ### ######### # ########### #####
#   #       #   #             # # # # # # #   # #   # #     # #   # # #           # #   #       #   #
# # # # ##### ####### ######### # # # ### # # # # ### ####### # ### # ############# # # # ####### # #
# #   # #     #     #     #     #   #     # # # #     #   #   # #   # #             # #   #       # #
# ##### # ##### ### ### # ######### ######### # # ##### # # ### # ### # ####### ##### ##### ####### #
#     # # # #   # #   # #           #       # # #   #   # # #   # # #   #     #     # #     #     # #
# ### ### # # ### ### # ############# # ### # # ### # # ### # ### # # ### ### ##### # # ##### ### # #
#   #   #   #   #   # #     #     #   # #     # #   # #   # # #   #     #   # # #   #   #     #   # #
### ### ### ### # ### ##### ### # ##### ####### # ####### # # # ####### # ### # # ### ######### # # #
#   #     #   # # #   # #       #     #     #   #   #   # # # #       # # #   # # #             # # #
# ### ### ### # # # ### # ########### ##### # ##### # # # # # ####### # # # ### # ### ############# #
#   #   # #   #   # #   # #         #       # #   # # # # # #   # #   # # #   # #   # #           # #
### ### # # ##### # ### # # ####### ####### # # ### # # # # # # # # ##### ### # ### ### ######### # #
# # #   # #   # # #   #   #     # #   #   # # #       # # #   #   # #       # #   #     # #     # # #
# # # ####### # # ### # ####### # ### # # # # ######### # ####### # # ####### ### ####### # ### # # #
# # #           # # # #   #     #   # # #   #     #             # # # #       #   #     #   #   #   #
# # ############# # # # ### ##### # # # ######### # ############# # # # ####### ### # # ##### ##### #
#   #     #     #   # # #   # #   # # #     #   # #   #           # # # #       #   # # #   # #   # #
# ### ### # ### ### # ### ### # ### # ##### # ### ### # ########### # # ##### ### ### # # # # # # # #
# #   #   # # # #   #     #       # #     # #   # #   #       #   #   # #   #   #   # # # # #   # # #
# ##### # # # # # ######### ####### ##### # ### # ######### ### # ### # # # ### ### # # # # ##### # #
# #     # #   #   # #         # #   #   # #   # #         # #   #   # #   # #   #   # #   #   #   # #
# # ##### ### ##### # ####### # # # # # # ### # ##### ##### # ##### ##### # # # # ### ####### # ### #
# #   # # # #   #     #   #     # # # # #   #       #       #     #     # # # # #   #     # #   #   #
# ### # # # ### ##### # # ####### # ### ### ### ##### ########### ##### ### # ##### ##### # # ### ###
#     # # #   #     # # # #     # #   #   #   # #   # #       # # #   #     # #   #     # #   #   # #
####### # # # ##### # # # # ### # ### # ##### # ### # ### ### # # # # ####### # # ### ### ##### ### #
# #     # # # #   # # # #   # # #   # #   #   # #   #   # #   # # # # #   #   # #     #   #   # #   #
# # # ### # # # # # # # ##### # # # # ### # ##### ##### # # ### # # # # # # # # ####### # # # # ### #
# # # #     # # #   # #     #   # # #   # #       #   #   # #   #   # # # # #     #     # # # #   # #
# # # # ####### ########### # ##### ### # ######### # ##### ### ##### # # ####### # ##### # # ### # #
#   # #   #     #           #       #       #     # #     #         #   #       # #     # # #   # # #
# ### ### # ####### # ##################### # # # ### # ####### ############### # ##### ### # ### # #
# #   #   # #     # # #         #     #   # # # #     # #       #               # #   #     #   #   #
### ### ### ### # # # # ####### # ### # # # # # ######### ####### ############### # # ######### ### #
#   #   # # #   #   # #       # #   # # # # # #   #             # #           #   # #         #     #
# # # ### # # ############### # ### # # ### ##### # ########### # ##### ### ### ########### # #######
# # # #   # # #   #           #     # # #   #     #     #   #   #     # # #   # #         # #       #
# ### # # # # # # # ################# # # ### ######### # # ######### # # ### # # ####### ##### ### #
#     # # # #   #       #   #   #     # # #   #         # #     #     #     # #   #     #       # # #
# ##### ### ############# # # # # ##### # # # # ######### ##### # ######### # ##### # # ######### # #
# #   #   #               #   # #     #   # #     #     #   #   # #   #     #       # #   #   #     #
# # ### # ##################### ##### # ### ####### ### ### # ### # ### ############# ### ### # #####
# #     #     #     #   #   #   #     # #     #     #   #   #   # #   #       #       #       # #   #
# ######### # # ### # # # # # ### ##### ####### ##### ### ##### # # # ####### # ############### ### #
#           #   #     #   # #     #             #         #       # #         #                     #
#####################################################################################################